#############################################################
#   #               #   #     #         #   #       #   #   #
# ### ######### ### # # ### # ### # ##### # ### ### ### # # #
#             # #   # # #   #     # #     #   # # #   #   # #
# ############# # ### # # ######### # ####### # # ### ##### #
#     #     #   #     # #   #     # # #     #   #   #       #
##### # ### # ######### ### # ### # # # ### ##### # ####### #
#   # # #   # #       #     # # # # # #   #       #   #     #
# # # # ### # ### # ######### # # # # ##### # # ####### #####
# #   #   # #   # # #           #   #     # # # #       #   #
# ####### # ### # # # ################### ### # # ####### # #
# #     # # #   # # #     #   #   #       #   # #   #     # #
# # ### # # # ### ####### # # # # # ####### ### ### ####### #
# # #     #   #         # # #   #   #       # # # #       # #
### ######### ##### ##### # ######### ####### # # ####### # #
#   #   #     #   #       #     #     #   #   #   #   #   # #
# # # # # ##### # ### ########### ### # # ### ### # ### ### #
# # # # # #     #   # #   #       #   # #   #   # # #   #   #
# # # # ### ####### # ### # ### ### ### ### # ### # # ##### #
# # # #     #   #   #   # #   #   #   # #   #       #       #
# ### ####### # # ##### # ### ### ##### # ######### ####### #
#     #   #   #   #     #   # # #     # #   #     # # #     #
# ####### # ####### ##### ### # ##### # ### # ### # # # #####
# #       #   #           #   #     #   # # # #   #   #     #
# # ##### ### ####### ##### ##### ####### # # # ########### #
# #   #     #     #   #     #   #         # # #   #   #     #
# # # ##### ##### ##### ##### # ### ##### # # ### # # # #####
# # #   # #   # #   #   #     #   #   # # # # # # # # # #   #
# ##### # ### # ### # ##### ##### ### # # # # # # # # # # # #
#       #         #         #         #   #     #   #     # #
#############################################################
