#############################################################
#           #     #       #   #           #             #   #
######### # ### # # ##### # # # # ####### # ########### ### #
#         # #   # # # #   # # # #   #   # # #         #     #
# ######### # ### # # # ### # ##### ### # # # ####### ##### #
# #   #   # #   #   #   #   # #   #   #     # #     #     # #
# # # # # # ### # ####### ### # # # # ######### ### ### # # #
# # #   #   #   # #       # # # # # #     #     #       # # #
# # ######### ### # ####### # # # # ##### # ##### ######### #
# #           #   #         # # # #     # # #   # #       # #
# ######### ####### ######### # # ### ### # # # ### ##### # #
#     # #   #       #     #   # #   # #   # # #     #   #   #
##### # # ### ####### ### # ### ### # # ### # ######### #####
#     #   # #   #     #     #   # # # # #     #             #
# ##### ### ### # # ####### # ### # ### # ##### ########### #
#   #     #   # # # #     # #   # #   # #   #       #     # #
# # ##### ### # # ### ### ####### ### # ### # ##### ### # # #
# # #   #     # #     # #             #   # # #   #   # #   #
# # # # ####### ####### ################# # ### # ### ### ###
# #   #   #     # #       #               #     #   #   # # #
# ####### # ##### # ##### # ##### # ############### # # # # #
#     # #   #   #   #     # #   # #             #   # # #   #
##### # ####### # ### ##### # # ############### # ### # #####
#   #   #     # #   #   #   # #     #   #     # # #   #     #
# ##### # ### # ### ### # ### ##### # # # ### # # ######### #
# #   # #   # #       #     #   # # # #   # #   #           #
# # # # # # # ################# # # # ##### ############### #
# # #   # # #   #         #     #   # #       #           # #
# # ####### ### # ####### # ##### ### # ### ### ####### ### #
#           #     #         #         #   #           #     #
#############################################################
