#############################################################
#   #       #     #   #       #       #   #             #   #
# ### ##### # ### # # ##### # # ##### # # # ####### # # # # #
#   #     # #   #   # #   # #       #   #   #     # # # # # #
# # ##### # # ####### # # ######### ##### ### ### ### # # ###
# # #   # #   #       # #         # #   #   # # #     # #   #
# # # # # ##### ##### # ######### ### # ### # # ####### # # #
# # # #   #   # #     # #       # #   #   # # # #       # # #
# # # ##### # # # ##### # # ##### # ##### ### # # ######### #
# #   #     # # #   #     # #   # # #         # # #         #
# ######### # # ##### ####### # # # ########### # # ####### #
#   #     # # #       #       # # # #     #       #     #   #
### # ### # ########### ####### # # # ### ### ##### ### # ###
#   # # # #       #   # #     # # #   # #   #   # # #   #   #
# ### # # ### # ### # # # ### # # ### # ### ### # # # ##### #
#     # #   # # #   # # #   # # #   #   # # # # #   # #     #
####### ### # ### ### # ### ####### ### # # # # # ### # #####
# #     #   #   #   # #   #         # # # # #   #   # #   # #
# # ### # ##### ### # ### # # ####### # # # # ####### ### # #
#   #   # #   #   # #   # # # # #       # # #         # #   #
##### ### # # ### # ### # # # # # ##### # # ########### ### #
#     #   # #     # # #   # # #   #   #   # #       # #     #
# ### # ### ##### # # ####### ##### # ### # # # ### # # #####
#   # # #       # # #         #     # #   # # # # #   # #   #
# # ### # ##### # # ### ####### ##### # ### ### # ### # ### #
# #     #     # # #     #         #   #   # #   #     #     #
# ########### # ################# # ####### # ### ######### #
# #   #     # #     #             # #     # # #   #         #
# # # # ### ##### # # ############# # ### # # ##### #########
#   #   #         #   #               #     #               #
#############################################################
