#############################################################
#       #     #           #       #           #       #     #
# ### # ##### # # ####### # ##### # ######### # # ### ### # #
# # # #     #   # #       #     # #       # # # # #     # # #
# # # ##### ##### # ########### ######### # # # # ##### ### #
#   #   # #       #     #     #         # #   # #   #     # #
# ##### # ############# # ### ### ### ### # ####### ##### # #
# #     #   #   #     #   # #     #   #   #   #   #   # #   #
### ##### ### # # ### ##### ####### ### ##### # # ### # ### #
#   #   #     #   # #   #     #   # # #     # # #     #     #
# ### # # ##### ### ### # ### # # # # ##### # # ####### #####
# #   #   #   #       #   # #   #     #   # # #       # #   #
# ######### # ########### # ##### ##### # # # ####### # ### #
#     #   # #           #   #   #   #   #   #   #   # #     #
# ### # # # ########### ### # # ### # ######### # # # ##### #
#   #   # #     #     #   # # # #   # #         # #   # #   #
### ##### ##### # ####### ### ####### # ######### ##### # ###
# # #   #       #       #   #         #         # #       # #
# # # # ############### ### ################### # # ####### #
# # # #             #   #   #         #       # # # # #     #
# # ######### ##### # # # ### ##### # ##### # # # # # # ### #
# #   #       #       # # #   # #   #       # # # # # #   # #
# ### # ####### ######### # ### # # ########### # # # ### # #
#   #   #   #   #         # #   # # #   #     # # # #     # #
# ####### ### ### ####### # ### # ### # # ### # # # ####### #
#   #   #     #   #   #   #   # #   # #   # #   # # #       #
# # # # # ##### ##### # ##### # ### # ##### ##### # # ##### #
# #   # #   # # #   #       # #   # # #   #     # # # # #   #
# ##### ### # # # # ######### ### # # # # # ### # # # # # ###
#     #       #   #               #     #   #     #   #     #
#############################################################
