#############################################################
#   #     #     #         #   #                 #           #
# # # # ### # ### # ##### # # # # ############# # ####### # #
# #   #     #     # # #   # #   #     #       # #   #   # # #
# ####### ####### # # # ########### # # ##### # ### # ### # #
# #     #   #   # # #   #         # # #     #   # # #   # # #
# # ### ### # # # # ### # ####### # # ##### ##### # ### # # #
# # # # # # # # # #   #   # #   # # # #     #     # #   # # #
### # # # # # # ### # ##### # # # ### # ######### # # # # # #
#   # # #   # #   # # #     # # # #   #   #     #   # # # # #
# ### # ### # ### ### # # ### # # # ##### # ### # ### # # ###
#   #     # #   #     # #     #     #   #   #   #     # #   #
# # ##### ##### ##################### ####### ############# #
# #   #   #   # #           #   #           #       #       #
# ### # ### # # # ######### # # # ##### ### ####### # #######
#   # # #   # #   #     #   # # # #     #     #   # #   #   #
##### # # ### # ### # # # ### ##### ######### # # # # # # # #
#     #   #   #   # # # #   #     #         # # # # # #   # #
# ######### ##### ### ##### ##### ######### # # # # ####### #
# #       # #   #     #   #     #         # #   # # #       #
# # ##### # # # ####### # ### # ######### # ####### # ##### #
#   # #   #   # #       #     # #       # # #     #   # #   #
# ### # ####### # ############# # ##### # # # ### ##### # ###
#     # #     #   #       #       #   # # # #   # #     #   #
##### # # ### ### ####### # ####### # # # # ### # # ### ### #
#   # #   # # #   #     # # # #   # # # # #     #   #   #   #
# # # ##### # ##### ### # # # # # # # # # # ######### ### ###
# # #   #   #       # # #     # #   # # # #   #     # #   # #
# # ### # # ######### # ####### ##### ### ### ### # # # ### #
# #       #           #             #     #       # #       #
#############################################################
