###################################################
#                                                 #
#                          #                      #
#                          #                      #
#                          #                      #
#                          #                      #
#                          #                      #
#                          #                      #
#                         #                       #
#                        #                        #
#                       #                         #
#                      #                          #
#                     #                           #
#                     #                           #
#                     #                           #
#                     #                           #
#                     #                           #
#               #######                           #
#                          #                      #
#                          #                      #
#                          #                      #
#                          #                      #
#                         #                       #
#                        #                        #
#                                                 #
#                          #                      #
#                          #                      #
#                          #                      #
#                          #                      #
#                         #                       #
#                        #                        #
#                                                 #
#                                                 #
#                                                 #
#                                                 #
#                                                 #
#                                                 #
#                                                 #
#                                                 #
#                                                 #
#                                                 #
#                                                 #
#                                                 #
#                                                 #
#                                                 #
#                                                 #
#                                                 #
#                                                 #
#                                                 #
#                                                 #
###################################################
